**Figuras Bidimensionales**
Círculo: Área = π * r²
Cuadrado: Área = a²
Decágono: Área = (5/2) * a² * cot(π/10)
Dodecágono: Área = 3 * a² * cot(π/12)
Elipse: Área = π * a * b
Enneágono (nonágono): Área = (9/4) * a² * cot(π/9)
Heptágono: Área = (7/4) * a² * cot(π/7)
Hexágono: Área = (3√3/2) * a²
Octágono: Área = 2 * (1 + √2) * a²
Pentágono: Área = (1/4) * √(5(5 + 2√5)) * a²
Rectángulo: Área = b * h
Rombo: Área = (d1 * d2) / 2
Trapecio: Área = (B + b) * h / 2
Triángulo: Área = (b * h) / 2
Triángulo equilátero: Área = (√3/4) * a²
Trilátero: Área = depende del tipo de triángulo (igual que el triángulo general)
Cuadrilátero: Área = depende del tipo específico de cuadrilátero
Polígono regular (n lados): Área = (n/4) * a² * cot(π/n)
Semicírculo: Área = (π * r²) / 2
Sector circular: Área = (θ/360) * π * r²
Segmento circular: Área = r²/2 * (θ - sinθ)
Corona circular: Área = π * (R² - r²)
Cuña: Área depende del sector y el ángulo.
Anillo: Área = π(R² - r²)
Polígono simple: Depende de la cantidad de vértices y la fórmula específica
Segmento elíptico: Área = ab(θ/360)
Triángulo isósceles: Área = (b * h) / 2
Triángulo rectángulo: Igual que el triángulo básico.
Paralelogramo: Área = b * h
Trapezoide: Igual al trapecio si las bases no son paralelas.
Circulo inscrito en polígono: Área del círculo en la fórmula adecuada.
Cuadrado con borde: Resta el borde del área.
Triángulo escaleno: Fórmulas con semiperímetro.
Cuadrado con circunferencia inscrita: Área del cuadrado = a²
Cuadrado con circunferencia circunscrita: Área = a²
Trapecio isósceles: Área = (B + b) * h / 2
Trapecio rectángulo: Igual que el trapecio general.
Cuadrilátero cóncavo: Área depende de las longitudes de los lados y la altura.
Heptágono regular: Área = (7/4) * a² * cot(π/7)
Enneágono irregular: El área se calcula dividiéndolo en triángulos.
Polígono estrellado (pentagrama): Área se calcula sumando los triángulos internos.
Octágono regular con apotema: Área = (Perímetro * apotema) / 2
Polígono irregular: El área se obtiene dividiéndolo en triángulos o cuadriláteros.

**Figuras Tridimensionales**
Figuras Tridimensionales (3D):
Cubo: Superficie = 6 * a²
Cilindro: Superficie = 2πr(h + r)
Cono: Superficie = πr(l + r)
Esfera: Superficie = 4πr²
Hemiesfera: Superficie = 3πr²
Pirámide cuadrada: Superficie = a² + 2a√(a²/4 + h²)
Prisma rectangular: Superficie = 2(lw + lh + wh)
Octaedro: Superficie = 2√3 * a²
Dodecaedro: Superficie = 3√25 + 10√5 * a²
Icosaedro: Superficie = 5√3 * a²
Tetraedro: Superficie = √3 * a²
Paralelepípedo: Superficie = 2(ab + ac + bc)
Toro: Superficie = 4π²rR
Prisma triangular: Superficie = bh + 3lw
Cilindro elíptico: Superficie = 2πa(b + h)
Pirámide hexagonal: Superficie = 3√3a² + 3al
Ortoedro: Superficie = 2lw + 2lh + 2wh
Pirámide pentagonal: Superficie = 5/2 * a * l + 5a²/4
Pirámide triangular: Superficie = 1/2 * P * l + B
Prisma pentagonal: Superficie = 5a(l + a)
Prisma hexagonal: Superficie = 6al + 3√3a²
Cono truncado: Superficie = π(R + r)√((R - r)² + h²) + πR² + πr²
Esferoide prolatado: Superficie aproximada = 2πb² + 2πa(b * arcsin(e)/e), donde e es la excentricidad.
Esferoide oblato: Superficie = 2πa²(1 + (1 - e²)/e * atanh(e))
Prisma trapezoidal: Superficie = Área lateral + áreas de las bases.
Antiprisma hexagonal: Superficie = Perímetro * altura + 2 * Área de base.
Bipirámide cuadrada: Superficie = 2a² + 4a√(h² + (a²/4))
Bipirámide triangular: Igual que la pirámide triangular pero duplicada.
Frustrum de pirámide: Superficie lateral + áreas de bases (a medida).
Toroide: Superficie = (2πr)(2πR)
Cilindro elíptico inclinado: Superficie depende de longitud de eje y ángulo.
Hemitoro: Superficie depende de las partes visibles y tangentes en la rotación.
